EntForest
An Interactive Fiction by Bruno
Release 1 / Serial number 210104 / Inform 7 build 6M62 (I6/v6.33 lib 6/12N) SD

GreenForest

Oh you mighty warrior, you are finding yourself in the Green Forest, the home of the cure, potions, and all the thing dear to a man to survive in this cruel and harsh world! 
Maybe you can find courage and power here to defeat the evil creatures that stand in your way to eternal life with the Ents!

You can see an Elixir of Courage, an Elixir of Peace, an Elixir of Inspiration, an ElvenKey and a Hole in the tree (closed) here.

>s
You can't go that way.

>w
You can't go that way.

>e
You can't go that way.

>n
You can't go that way.

I beg your pardon?

>take cure
You can't see any such thing.

>take
What do you want to take?

>inv
You are carrying nothing.

>drop
What do you want to drop?

>go south
You can't go that way.

* * *

EntForest
An Interactive Fiction by Bruno
Release 1 / Serial number 210104 / Inform 7 build 6M62 (I6/v6.33 lib 6/12N) SD

GreenForest

Oh you mighty warrior, you are finding yourself in the Green Forest, the home of the cure, potions, and all the thing dear to a man to survive in this cruel and harsh world! 
Maybe you can find courage and power here to defeat the evil creatures that stand in your way to eternal life with the Ents!

You can see an Elixir of Courage, an Elixir of Peace, an Elixir of Inspiration, an ElvenKey and a Hole in the tree (closed) here.

>w
BlueForest

You can find yourself in the Blue Forest where you see things of great value that can help you on your journey across the Cursed Forest. You can see a wooden desk with weapons that were forged in the eternal fires and cooled down in the freezing deeps of the northern sea!
Maybe some friend can help you with your journey as well?

You can see a Gates of fortress, Archer, Wizard, Swordsman, a Grass (closed) and a Wooden desk (closed) here.

>e
GreenForest

Oh you mighty warrior, you are finding yourself in the Green Forest, the home of the cure, potions, and all the thing dear to a man to survive in this cruel and harsh world! 
Maybe you can find courage and power here to defeat the evil creatures that stand in your way to eternal life with the Ents!

You can see an Elixir of Courage, an Elixir of Peace, an Elixir of Inspiration, an ElvenKey and a Hole in the tree (closed) here.

>w
BlueForest
You can find yourself in the Blue Forest where you see things of great value that can help you on your journey across the Cursed Forest. You can see a wooden desk with weapons that were forged in the eternal fires and cooled down in the freezing deeps of the northern sea! Maybe some friend can help you on your journey aswell?

You can see Green forest rising in the east and Old Elven fortress standing in the south!

You can see a Gates of fortress, Archer, Wizard, Swordsman, a Grass (closed) and a Wooden desk (closed) here.

>e
GreenForest
Oh you mighty warrior, you are finding yourself in the Green Forest, the home of the cure, potions, and all the thing dear to a man to survive in this cruel and harsh world! Maybe you can find courage and power here to defeat the evil creatures that stand in your way to the eternal life with the Ents!

You can see Blue forest rising in the west and in the east there is a Cursed forest and the road you must take!

You can see an Elixir of Courage, an Elixir of Peace, an Elixir of Inspiration, an ElvenKey and a Hole in the tree (closed) here.

>w
BlueForest
You can find yourself in the Blue Forest where you see things of great value that can help you on your journey across the Cursed Forest. You can see a wooden desk with weapons that were forged in the eternal fires and cooled down in the freezing deeps of the northern sea! Maybe some friend can help you on your journey aswell?

You can see Green forest rising in the east and Old Elven fortress standing in the south!

You can see a Gates of fortress, Archer, Wizard, Swordsman, a Grass (closed) and a Wooden desk (closed) here.

>s
(first opening the Gates of fortress)

OldElvenFortress
Forgoten for ages, lost in the books, now only ruins remain of once great elven fortress. Mistery surrounds this place, ghost fly by you, but don't be scared, it's a peaceful place. Try to find something useful. It looks like there's still some weapons here that stood for ages and are stiill standing like the time stopped for them. Must be that Elves used some kind of magic on them. . . But be aware that while you look out for weapons your enemies grow stronger!

You can see a Gates of fortress, White arrow, Green arrow, Black arrow and Stone grave (closed) here.

>n
BlueForest
You can find yourself in the Blue Forest where you see things of great value that can help you on your journey across the Cursed Forest. You can see a wooden desk with weapons that were forged in the eternal fires and cooled down in the freezing deeps of the northern sea! Maybe some friend can help you on your journey aswell?

You can see Green forest rising in the east and Old Elven fortress standing in the south!

You can see a Gates of fortress, Archer, Wizard, Swordsman, a Grass (closed) and a Wooden desk (closed) here.

>s
OldElvenFortress
Forgoten for ages, lost in the books, now only ruins remain of once great elven fortress. Mistery surrounds this place, ghost fly by you, but don't be scared, it's a peaceful place. Try to find something useful. It looks like there's still some weapons here that stood for ages and are stiill standing like the time stopped for them. Must be that Elves used some kind of magic on them. . . But be aware that while you look out for weapons your enemies grow stronger!

You can see a Gates of fortress, White arrow, Green arrow, Black arrow and Stone grave (closed) here.

>e
You can't go that way.

>w
You can't go that way.

>s
You can't go that way.

>n
BlueForest
You can find yourself in the Blue Forest where you see things of great value that can help you on your journey across the Cursed Forest. You can see a wooden desk with weapons that were forged in the eternal fires and cooled down in the freezing deeps of the northern sea! Maybe some friend can help you on your journey aswell?

You can see Green forest rising in the east and Old Elven fortress standing in the south!

You can see a Gates of fortress, Archer, Wizard, Swordsman, a Grass (closed) and a Wooden desk (closed) here.

>e
GreenForest
Oh you mighty warrior, you are finding yourself in the Green Forest, the home of the cure, potions, and all the thing dear to a man to survive in this cruel and harsh world! Maybe you can find courage and power here to defeat the evil creatures that stand in your way to the eternal life with the Ents!

You can see Blue forest rising in the west and in the east there is a Cursed forest and the road you must take!

You can see an Elixir of Courage, an Elixir of Peace, an Elixir of Inspiration, an ElvenKey and a Hole in the tree (closed) here.

>e
CursedForest
Ground hasn't seen the ligh for ages, rivers stopped flowing and leaves mourn the life that was once here, but no more. Cursed is the place where you are. Be aware of going alone. Don't even try without right equipment. The Orcs on the branches fight until the end and guard the entrance of the forest. If you win the fight you will come across the Trolls that smash hard and fear no one! If you manage to get through all of that, only magic can save you becase Deamon from the deep, the almighty ghost that roams these forest is feared by all living things and no solid thing can hurt him!

Go east if you dare . . .

>e
GreenForest
Oh you mighty warrior, you are finding yourself in the Green Forest, the home of the cure, potions, and all the thing dear to a man to survive in this cruel and harsh world! Maybe you can find courage and power here to defeat the evil creatures that stand in your way to the eternal life with the Ents!

You can see Blue forest rising in the west and in the east there is a Cursed forest and the road you must take!

You can see an Elixir of Courage, an Elixir of Peace, an Elixir of Inspiration, an ElvenKey and a Hole in the tree (closed) here.

You will lose your life, don't risk it. Find the right items my friend!

>look
GreenForest
Oh you mighty warrior, you are finding yourself in the Green Forest, the home of the cure, potions, and all the thing dear to a man to survive in this cruel and harsh world! Maybe you can find courage and power here to defeat the evil creatures that stand in your way to the eternal life with the Ents!

You can see Blue forest rising in the west and in the east there is a Cursed forest and the road you must take!

You can see an Elixir of Courage, an Elixir of Peace, an Elixir of Inspiration, an ElvenKey and a Hole in the tree (closed) here.

* * *

>e
GreenForest

Oh you mighty warrior, you are finding yourself in the Green Forest, the home of the cure, potions, and all the thing dear to a man to survive in this cruel and harsh world! 
Maybe you can find courage and power here to defeat the evil creatures that stand in your way to eternal life with the Ents!

You can see an Elixir of Courage, an Elixir of Peace, an Elixir of Inspiration, an ElvenKey and a Hole in the tree (closed) here.

>e
CursedForest

The ground hasn't seen the light for ages, rivers stopped flowing and leaves mourn the life that was once here, but no more. Cursed is the place where you are. Be aware of going alone. Don't even try without the right equipment. The Orcs on the branches fight until the end and guard the entrance of the forest. If you win the fight, you will come across the Trolls that smash hard and fear no one! If you manage to get through all of that, only magic can save you because Demon from the deep, the almighty ghost that roams this forest is feared by all living things and no solid thing can hurt him!

Go south if you dare . . .

>s
You will lose your life, don't risk it. Find the right items, my friend!

GreenForest

Oh you mighty warrior, you are finding yourself in the Green Forest, the home of the cure, potions, and all the thing dear to a man to survive in this cruel and harsh world! 
Maybe you can find courage and power here to defeat the evil creatures that stand in your way to eternal life with the Ents!

You can see an Elixir of Courage, an Elixir of Peace, an Elixir of Inspiration, an ElvenKey and a Hole in the tree (closed) here.

* * *

>w
BlueForest

You can find yourself in the Blue Forest where you see things of great value that can help you on your journey across the Cursed Forest. You can see a wooden desk with weapons that were forged in the eternal fires and cooled down in the freezing deeps of the northern sea!
Maybe some friend can help you with your journey as well?

You can see a Gates of fortress, Archer, Wizard, Swordsman, a Grass (closed) and a Wooden desk (closed) here.

>n
You can't go that way.

>e
GreenForest
Oh you mighty warior, you are finding yourself in the Green Forest, the home of the cure, potions, and all the thing dear to a man to survive in this cruel and harsh world! Maybe you can find courage and power here to defeat the evil creatures that stand in your way to the eternal life with the Ents!

Hmm . . . There is some key on the ground? Maybe some ancient people forgot about it. Must be to unlock something. It looks kinda elvish!

You can also see an Elixir of Courage, an Elixir of Peace and a Hole in the wood (closed) here.

>n
GreenForest
Oh you mighty warior, you are finding yourself in the Green Forest, the home of the cure, potions, and all the thing dear to a man to survive in this cruel and harsh world! Maybe you can find courage and power here to defeat the evil creatures that stand in your way to the eternal life with the Ents!

Hmm . . . There is some key on the ground? Maybe some ancient people forgot about it. Must be to unlock something. It looks kinda elvish!

You can also see an Elixir of Courage, an Elixir of Peace and a Hole in the wood (closed) here.

You're not happy, you can't go north yet

* * *

>w
BlueForest

You can find yourself in the Blue Forest where you see things of great value that can help you on your journey across the Cursed Forest. You can see a wooden desk with weapons that were forged in the eternal fires and cooled down in the freezing deeps of the northern sea!
Maybe some friend can help you with your journey as well?

You can see a Gates of fortress, Archer, Wizard, Swordsman, a Grass (closed) and a Wooden desk (closed) here.

>open desk
It seems to be locked.

>take grasskey
You can't see any such thing.

* * *

>w
BlueForest

You can find yourself in the Blue Forest where you see things of great value that can help you on your journey across the Cursed Forest. You can see a wooden desk with weapons that were forged in the eternal fires and cooled down in the freezing deeps of the northern sea!
Maybe some friend can help you with your journey as well?

You can see a Gates of fortress, Archer, Wizard, Swordsman, a Grass (closed) and a Wooden desk (closed) here.

>look grass
That is some tall grass . . . Maybe there's snakes in it? Maybe some useful things. Should you look inside?

>open grass
You open the Grass, revealing a GrassKey.

>take GrassKey
Taken.

>e
GreenForest
Oh you mighty warior, you are finding yourself in the Green Forest, the home of the cure, potions, and all the thing dear to a man to survive in this cruel and harsh world! Maybe you can find courage and power here to defeat the evil creatures that stand in your way to the eternal life with the Ents!

You can see an Elixir of Courage, an Elixir of Peace, an Elixir of Inspiration, an ElvenKey and a Hole in the wood (closed) here.

>w
BlueForest
You can find yourself in the Blue Forest where you see things of great value that can help you on your journey across the Cursed Forest. You can see a wooden desk with weapons that were forged in the eternal fires and cooled down in the freezing deeps of the northern sea! Maybe some friend can help you on your journey aswell?

You can see Archer, Wizard, Swordsman, a Grass (empty) and a Wooden desk (closed) here.

>look grass
That is some tall grass . . . Maybe there's snakes in it? Maybe some useful things. Should you look inside?

>open grass
That's already open.

>open Grass
That's already open.

>enter grass
That's not something you can enter.

>open desk
It seems to be locked.

>take key
You can't see any such thing.

>take GrassKey
You already have that.

>open Grass
That's already open.

>look grass
That is some tall grass . . . Maybe there's snakes in it? Maybe some useful things. Should you look inside?

* * *

>open grass
That's already open.

>e
GreenForest
Oh you mighty warior, you are finding yourself in the Green Forest, the home of the cure, potions, and all the thing dear to a man to survive in this cruel and harsh world! Maybe you can find courage and power here to defeat the evil creatures that stand in your way to the eternal life with the Ents!

You can see an Elixir of Courage, an Elixir of Peace, an Elixir of Inspiration, an ElvenKey and a Hole in the wood (closed) here.

* * *

>w
BlueForest
You can find yourself in the Blue Forest where you see things of great value that can help you on your journey across the Cursed Forest. You can see a wooden desk with weapons that were forged in the eternal fires and cooled down in the freezing deeps of the northern sea! Maybe some friend can help you on your journey aswell?

You can see Archer, Wizard, Swordsman, a Grass (empty) and a Wooden desk (closed) here.

>see Grass
That's not a verb I recognise.

>watch Grass
That is some tall grass . . . Maybe there's snakes in it? Maybe some useful things. Should you look inside?

>open Grass
That's already open.

>open grass
That's already open.

* * *

>open grass
You open the Grass, revealing a GrassKey.

>take key
You can't see any such thing.

>take Grasskey
Taken.

>inv
You are carrying:
  a GrassKey

>greenforest
That's not a verb I recognise.

>GreenForest
That's not a verb I recognise.

>look
BlueForest
You can find yourself in the Blue Forest where you see things of great value that can help you on your journey across the Cursed Forest. You can see a wooden desk with weapons that were forged in the eternal fires and cooled down in the freezing deeps of the northern sea! Maybe some friend can help you on your journey aswell?

You can see Green forest rising in the east and Old Elven fortress standing in the south!

You can see a Gates of fortress, Archer, Wizard, Swordsman, a Grass (empty) and a Wooden desk (closed) here.

>open desk
It seems to be locked.

>unlock desk
(with the GrassKey)
You unlock the Wooden desk.

>open desk
You open the Wooden desk, revealing White staff, Green staff and Black staff.

>look Wizard
He is useless without his staff. Find him his weapon and summon his to the Cursed forest!

>take white staff
You have summoned the White Wizard to the Cursed forest!

Taken.

>look
BlueForest
You can find yourself in the Blue Forest where you see things of great value that can help you on your journey across the Cursed Forest. You can see a wooden desk with weapons that were forged in the eternal fires and cooled down in the freezing deeps of the northern sea! Maybe some friend can help you on your journey aswell?

You can see Green forest rising in the east and Old Elven fortress standing in the south!

You can see a Gates of fortress, Archer, Swordsman, a Grass (empty) and a Wooden desk (in which are Green staff and Black staff) here.

>e
GreenForest
Oh you mighty warrior, you are finding yourself in the Green Forest, the home of the cure, potions, and all the thing dear to a man to survive in this cruel and harsh world! Maybe you can find courage and power here to defeat the evil creatures that stand in your way to the eternal life with the Ents!

You can see Blue forest rising in the west and in the east there is a Cursed forest and the road you must take!

You can see an Elixir of Courage, an Elixir of Peace, an Elixir of Inspiration, an ElvenKey and a Hole in the tree (closed) here.

>e
CursedForest
Ground hasn't seen the ligh for ages, rivers stopped flowing and leaves mourn the life that was once here, but no more. Cursed is the place where you are. Be aware of going alone. Don't even try without right equipment. The Orcs on the branches fight until the end and guard the entrance of the forest. If you win the fight you will come across the Trolls that smash hard and fear no one! If you manage to get through all of that, only magic can save you becase Deamon from the deep, the almighty ghost that roams these forest is feared by all living things and no solid thing can hurt him!

Go east if you dare . . .

You can see Wizard here.

>e
EntForest
You are in peace my friend. Congratulations!

>inv
You are carrying:
  White staff
  a GrassKey

* * *

>w
BlueForest

You can find yourself in the Blue Forest where you see things of great value that can help you on your journey across the Cursed Forest. You can see a wooden desk with weapons that were forged in the eternal fires and cooled down in the freezing deeps of the northern sea!
Maybe some friend can help you with your journey as well?

You can see a Gates of fortress, Archer, Wizard, Swordsman, a Grass (closed) and a Wooden desk (closed) here.

>open grass
You open the Grass, revealing a GrassKey.

>look grass
That is some tall grass . . . Maybe there's snakes in it? Maybe some useful things. Should you look inside?

In the Grass is a GrassKey.

>unlock desk
What do you want to unlock the Wooden desk with?

>take key
You can't see any such thing.

>open grass
That's already open.

>take GrassKey
Taken.

>open desk
It seems to be locked.

* * *

>unlock desk
(with the GrassKey)
You unlock the Wooden desk.

>look desk
Oh those wooden desks of old . . .  You can smell the power and greatness that they hold!

>look desk
Oh those wooden desks of old . . .  You can smell the power and greatness that they hold!

>open desk
You open the Wooden desk, revealing White staff, Green staff and Black staff.

>look white
Those magical white staff must be for something evil and demonic!

>look green
Those magical green staff must be for something greeen and peaceful!

>look black
Those magical black staff must be for something that's in the mines, it's so dusty . . .

>open Gates
You open the Gates of fortress.

>s
OldElvenFortress
Forgoten for ages, lost in the books, now only ruins remain of once great elven fortress. Mistery surrounds this place, ghost fly by you, but don't be scared, it's a peaceful place. Try to find something useful. It looks like there's still some weapons here that stood for ages and are stiill standing like the time stopped for them. Must be that Elves used some kind of magic on them. . . But be aware that while you look out for weapons you're enemies grow stronger!

You can see a Gates of fortress, White arrow, Green arrow, Black arrow and Stone grave (closed) here.

>a
That's not a verb I recognise.

>s
You can't go that way.

>n
BlueForest
You can find yourself in the Blue Forest where you see things of great value that can help you on your journey across the Cursed Forest. You can see a wooden desk with weapons that were forged in the eternal fires and cooled down in the freezing deeps of the northern sea! Maybe some friend can help you on your journey aswell?

You can see a Gates of fortress, Archer, Wizard, Swordsman, a Grass (empty) and a Wooden desk (in which are White staff, Green staff and Black staff) here.

>s
OldElvenFortress
Forgoten for ages, lost in the books, now only ruins remain of once great elven fortress. Mistery surrounds this place, ghost fly by you, but don't be scared, it's a peaceful place. Try to find something useful. It looks like there's still some weapons here that stood for ages and are stiill standing like the time stopped for them. Must be that Elves used some kind of magic on them. . . But be aware that while you look out for weapons you're enemies grow stronger!

You can see a Gates of fortress, White arrow, Green arrow, Black arrow and Stone grave (closed) here.

>close gates
You close the Gates of fortress.

>n
(first opening the Gates of fortress)

BlueForest
You can find yourself in the Blue Forest where you see things of great value that can help you on your journey across the Cursed Forest. You can see a wooden desk with weapons that were forged in the eternal fires and cooled down in the freezing deeps of the northern sea! Maybe some friend can help you on your journey aswell?

You can see a Gates of fortress, Archer, Wizard, Swordsman, a Grass (empty) and a Wooden desk (in which are White staff, Green staff and Black staff) here.

>s
OldElvenFortress
Forgoten for ages, lost in the books, now only ruins remain of once great elven fortress. Mistery surrounds this place, ghost fly by you, but don't be scared, it's a peaceful place. Try to find something useful. It looks like there's still some weapons here that stood for ages and are stiill standing like the time stopped for them. Must be that Elves used some kind of magic on them. . . But be aware that while you look out for weapons you're enemies grow stronger!

You can see a Gates of fortress, White arrow, Green arrow, Black arrow and Stone grave (closed) here.

>n
BlueForest
You can find yourself in the Blue Forest where you see things of great value that can help you on your journey across the Cursed Forest. You can see a wooden desk with weapons that were forged in the eternal fires and cooled down in the freezing deeps of the northern sea! Maybe some friend can help you on your journey aswell?

You can see a Gates of fortress, Archer, Wizard, Swordsman, a Grass (empty) and a Wooden desk (in which are White staff, Green staff and Black staff) here.

>close gates
You close the Gates of fortress.

>s
(first opening the Gates of fortress)

OldElvenFortress
Forgoten for ages, lost in the books, now only ruins remain of once great elven fortress. Mistery surrounds this place, ghost fly by you, but don't be scared, it's a peaceful place. Try to find something useful. It looks like there's still some weapons here that stood for ages and are stiill standing like the time stopped for them. Must be that Elves used some kind of magic on them. . . But be aware that while you look out for weapons you're enemies grow stronger!

You can see a Gates of fortress, White arrow, Green arrow, Black arrow and Stone grave (closed) here.

>look gates
You see nothing special about the Gates of fortress.

>look white
Maybe you can see enemies in the dark with white arrow.

>look black
If you need defence against stone giants, there is nothing better than black arrow!

>look green
Hmm . . . There is saying that green arrow can be good for aiming high!

>open grave
You open Stone grave, revealing White sword, Green sword and Black sword.

>look white
(White arrow)
Maybe you can see enemies in the dark with white arrow.

>look green
(Green arrow)
Hmm . . . There is saying that green arrow can be good for aiming high!

>look black
(Black arrow)
If you need defence against stone giants, there is nothing better than black arrow!

>look whte sword
You can't see any such thing.

>look White sword
White swords were carried by the kings of old. The high lords of Elves and keepers of the peace.

>look white sword
White swords were carried by the kings of old. The high lords of Elves and keepers of the peace.

>look green sword
Green sword is said to be worn be the Quens of might and magic!

>look black sword
Black sword is the one that all Orcs fear and flee before it!

>s
You can't go that way.

* * *

>w
You can't go that way.

>n
BlueForest
You can find yourself in the Blue Forest where you see things of great value that can help you on your journey across the Cursed Forest. You can see a wooden desk with weapons that were forged in the eternal fires and cooled down in the freezing deeps of the northern sea! Maybe some friend can help you on your journey aswell?

You can see a Gates of fortress, Archer, Wizard, Swordsman, a Grass (empty) and a Wooden desk (in which are White staff, Green staff and Black staff) here.

>inv
You are carrying:
  a GrassKey

>close deks
You can't see any such thing.

>close desk
You close the Wooden desk.

>look
BlueForest
You can find yourself in the Blue Forest where you see things of great value that can help you on your journey across the Cursed Forest. You can see a wooden desk with weapons that were forged in the eternal fires and cooled down in the freezing deeps of the northern sea! Maybe some friend can help you on your journey aswell?

You can see a Gates of fortress, Archer, Wizard, Swordsman, a Grass (empty) and a Wooden desk (closed) here.

>e
GreenForest
Oh you mighty warior, you are finding yourself in the Green Forest, the home of the cure, potions, and all the thing dear to a man to survive in this cruel and harsh world! Maybe you can find courage and power here to defeat the evil creatures that stand in your way to the eternal life with the Ents!

You can see an Elixir of Courage, an Elixir of Peace, an Elixir of Inspiration, an ElvenKey and a Hole in the wood (closed) here.

>e
CursedForest
Ground hasn't seen the ligh for ages, rivers stopped flowing and leaves mourn the life that was once here, but no more. Cursed is the place where you are. Be aware of going alone. Don't even try without right equipment. The Orcs on the branches fight until the end and guard the entrance of the forest. If you win the fight you will come across the Trolls that smash hard and fear no one! If you manage to get through all of that, only magic can save you becase Deamon from the deep, the almighty ghost that roams these forest is feared by all living things and no solid thing can hurt him!

>e
BlueForest
You can find yourself in the Blue Forest where you see things of great value that can help you on your journey across the Cursed Forest. You can see a wooden desk with weapons that were forged in the eternal fires and cooled down in the freezing deeps of the northern sea! Maybe some friend can help you on your journey aswell?

You can see a Gates of fortress, Archer, Wizard, Swordsman, a Grass (empty) and a Wooden desk (closed) here.

You will lose your life, don't risk it. Find the right items my friend!

>open desk
You open the Wooden desk, revealing White staff, Green staff and Black staff.

>take white staff
Taken.

>look gates
You see nothing special about the Gates of fortress.

>open gates
That's already open.

>n
You can't go that way.

>s
OldElvenFortress
Forgoten for ages, lost in the books, now only ruins remain of once great elven fortress. Mistery surrounds this place, ghost fly by you, but don't be scared, it's a peaceful place. Try to find something useful. It looks like there's still some weapons here that stood for ages and are stiill standing like the time stopped for them. Must be that Elves used some kind of magic on them. . . But be aware that while you look out for weapons you're enemies grow stronger!

You can see a Gates of fortress, White arrow, Green arrow, Black arrow and Stone grave (in which are White sword, Green sword and Black sword) here.

>take green arrow
Taken.

>open grave
That's already open.

>take black sword
Taken.

>s
You can't go that way.

>n
BlueForest
You can find yourself in the Blue Forest where you see things of great value that can help you on your journey across the Cursed Forest. You can see a wooden desk with weapons that were forged in the eternal fires and cooled down in the freezing deeps of the northern sea! Maybe some friend can help you on your journey aswell?

You can see a Gates of fortress, Archer, Wizard, Swordsman, a Grass (empty) and a Wooden desk (in which are Green staff and Black staff) here.

>e
GreenForest
Oh you mighty warior, you are finding yourself in the Green Forest, the home of the cure, potions, and all the thing dear to a man to survive in this cruel and harsh world! Maybe you can find courage and power here to defeat the evil creatures that stand in your way to the eternal life with the Ents!

You can see an Elixir of Courage, an Elixir of Peace, an Elixir of Inspiration, an ElvenKey and a Hole in the wood (closed) here.

>w
BlueForest
You can find yourself in the Blue Forest where you see things of great value that can help you on your journey across the Cursed Forest. You can see a wooden desk with weapons that were forged in the eternal fires and cooled down in the freezing deeps of the northern sea! Maybe some friend can help you on your journey aswell?

You can see a Gates of fortress, Archer, Wizard, Swordsman, a Grass (empty) and a Wooden desk (in which are Green staff and Black staff) here.

>w
You can't go that way.

>s
OldElvenFortress
Forgoten for ages, lost in the books, now only ruins remain of once great elven fortress. Mistery surrounds this place, ghost fly by you, but don't be scared, it's a peaceful place. Try to find something useful. It looks like there's still some weapons here that stood for ages and are stiill standing like the time stopped for them. Must be that Elves used some kind of magic on them. . . But be aware that while you look out for weapons you're enemies grow stronger!

You can see a Gates of fortress, White arrow, Black arrow and Stone grave (in which are White sword and Green sword) here.

>w
You can't go that way.

* * *

>e
You can't go that way.

>n
BlueForest
You can find yourself in the Blue Forest where you see things of great value that can help you on your journey across the Cursed Forest. You can see a wooden desk with weapons that were forged in the eternal fires and cooled down in the freezing deeps of the northern sea! Maybe some friend can help you on your journey aswell?

You can see a Gates of fortress, Archer, Wizard, Swordsman, a Grass (empty) and a Wooden desk (in which are Green staff and Black staff) here.

>s
OldElvenFortress
Forgoten for ages, lost in the books, now only ruins remain of once great elven fortress. Mistery surrounds this place, ghost fly by you, but don't be scared, it's a peaceful place. Try to find something useful. It looks like there's still some weapons here that stood for ages and are stiill standing like the time stopped for them. Must be that Elves used some kind of magic on them. . . But be aware that while you look out for weapons you're enemies grow stronger!

You can see a Gates of fortress, White arrow, Black arrow and Stone grave (in which are White sword and Green sword) here.

>n
BlueForest
You can find yourself in the Blue Forest where you see things of great value that can help you on your journey across the Cursed Forest. You can see a wooden desk with weapons that were forged in the eternal fires and cooled down in the freezing deeps of the northern sea! Maybe some friend can help you on your journey aswell?

You can see a Gates of fortress, Archer, Wizard, Swordsman, a Grass (empty) and a Wooden desk (in which are Green staff and Black staff) here.

>w
You can't go that way.

>n
You can't go that way.

>w
You can't go that way.

>e
GreenForest
Oh you mighty warior, you are finding yourself in the Green Forest, the home of the cure, potions, and all the thing dear to a man to survive in this cruel and harsh world! Maybe you can find courage and power here to defeat the evil creatures that stand in your way to the eternal life with the Ents!

You can see an Elixir of Courage, an Elixir of Peace, an Elixir of Inspiration, an ElvenKey and a Hole in the wood (closed) here.

* * *

>e
EntForest
You are in peace my friend. Congratulations!

* * *

EntForest
An Interactive Fiction by Bruno
Release 1 / Serial number 210104 / Inform 7 build 6M62 (I6/v6.33 lib 6/12N) SD

GreenForest

Oh you mighty warrior, you are finding yourself in the Green Forest, the home of the cure, potions, and all the thing dear to a man to survive in this cruel and harsh world! 
Maybe you can find courage and power here to defeat the evil creatures that stand in your way to eternal life with the Ents!

You can see an Elixir of Courage, an Elixir of Peace, an Elixir of Inspiration, an ElvenKey and a Hole in the tree (closed) here.

>take elixir
Which do you mean, the Elixir Of Curage or the Elixir Of Peace?

>inv
You are carrying:
  an Elixir Of Curage

>drop elixir
Dropped.

>take courage
You can't see any such thing.

>w
BlueForest
You can find yourself in the Blue Forest where you see things of great value that can help you on your journey across the Cursed Forest. You can see a desk with weapons that were forged in the eternal fires and cooled down in the freezing deeps of the northern sea!

* * *

>take elixir
Which do you mean, the Elixir Of Curage or the Elixir Of Peace?

>elixir of peace
Taken.

* * *

EntForest
An Interactive Fiction by Bruno
Release 1 / Serial number 210104 / Inform 7 build 6M62 (I6/v6.33 lib 6/12N) SD

GreenForest

Oh you mighty warrior, you are finding yourself in the Green Forest, the home of the cure, potions, and all the thing dear to a man to survive in this cruel and harsh world! 
Maybe you can find courage and power here to defeat the evil creatures that stand in your way to eternal life with the Ents!

You can see an Elixir of Courage, an Elixir of Peace, an Elixir of Inspiration, an ElvenKey and a Hole in the tree (closed) here.

>take elixir of power
Taken.

>inv
You are carrying:
  an Elixir of Power

>drop elixir
(the Elixir of Power)
Dropped.

* * *

EntForest
An Interactive Fiction by Bruno
Release 1 / Serial number 210104 / Inform 7 build 6M62 (I6/v6.33 lib 6/12N) SD

GreenForest

Oh you mighty warrior, you are finding yourself in the Green Forest, the home of the cure, potions, and all the thing dear to a man to survive in this cruel and harsh world! 
Maybe you can find courage and power here to defeat the evil creatures that stand in your way to eternal life with the Ents!

You can see an Elixir of Courage, an Elixir of Peace, an Elixir of Inspiration, an ElvenKey and a Hole in the tree (closed) here.

>look cabinet
Who knows what opening up the cabinet can bring you. Maybe happiness? Maybe power? Maybe just nothing? Oh well . . . 

In the Cabinet are an Elixir of Happiness and an Elixir of Power.

>open cabinet
You open the Cabinet.

>take elixir of power
You can't see any such thing.

>take power
Taken.

>inv
You are carrying:
  Power

* * *

>open cabinet
You open the Cabinet.

>take elixir
Which do you mean, the Elixir of Courage, the Elixir of Peace, the Elixir of Insiration, the Elixir of Happiness or the Elixir of Power?

>elixir of power
Taken.

>close cabinet
You close the Cabinet.

* * *

EntForest
An Interactive Fiction by Bruno
Release 1 / Serial number 210104 / Inform 7 build 6M62 (I6/v6.33 lib 6/12N) SD

GreenForest

Oh you mighty warrior, you are finding yourself in the Green Forest, the home of the cure, potions, and all the thing dear to a man to survive in this cruel and harsh world! 
Maybe you can find courage and power here to defeat the evil creatures that stand in your way to eternal life with the Ents!

You can see an Elixir of Courage, an Elixir of Peace, an Elixir of Inspiration, an ElvenKey and a Hole in the tree (closed) here.

>open cage
You open the cage.

>close cage
You close the cage.

>look cage
In the cage is a lion.

>enter cage
You can't get into the closed cage.

>open cage
You open the cage.

>enter cage
You get into the cage.

In the cage you can see a lion.

>get in the cage
But you're already in the cage.

>n
You would have to get out of the cage first.

>s
You would have to get out of the cage first.

>exit cage
I only understood you as far as wanting to exit.

>get out the cage
I only understood you as far as wanting to get outside.

>open cage
That's already open.

>close cage
You close the cage.

>exit cage
I only understood you as far as wanting to exit.

>enter cage
But you're already in the cage.

>transparent
That's not a verb I recognise.

>both
That's not a verb I recognise.

>out
You can't get out of the closed cage.

>open cage
You open the cage.

>out
You get out of the cage.

Center Ring
You can see a cage (in which is a lion) here.

>close cage
You close the cage.

* * *

EntForest
An Interactive Fiction by Bruno
Release 1 / Serial number 210104 / Inform 7 build 6M62 (I6/v6.33 lib 6/12N) SD

GreenForest

Oh you mighty warrior, you are finding yourself in the Green Forest, the home of the cure, potions, and all the thing dear to a man to survive in this cruel and harsh world! 
Maybe you can find courage and power here to defeat the evil creatures that stand in your way to eternal life with the Ents!

You can see an Elixir of Courage, an Elixir of Peace, an Elixir of Inspiration, an ElvenKey and a Hole in the tree (closed) here.

>enter
You can't get into the closed Cabinet.

>open
What do you want to open?

>open c
You can't see any such thing.

>open cabinet
You open the Cabinet.

>enter
You get into the Cabinet.

In the Cabinet you can see an Elixir of Happiness.

>take elixir
Which do you mean, the Elixir of Courage, the Elixir of Peace, the Elixir of Power, the Elixir of Insiration or the Elixir of Happiness?

>take elixir of happiness
Taken.

>out
You get out of the Cabinet.

GreenForest
Oh you mighty warior, you are finding yourself in the Green Forest, the home of the cure, potions, and all the thing dear to a man to survice in this cruel and harsh world!

You can see an Elixir of Courage, an Elixir of Peace, an Elixir of Power, an Elixir of Insiration and the Cabinet (empty) here.

>drop elixir
(the Elixir of Happiness)
Dropped.

>see
That's not a verb I recognise.

>look
GreenForest
Oh you mighty warior, you are finding yourself in the Green Forest, the home of the cure, potions, and all the thing dear to a man to survice in this cruel and harsh world!

You can see an Elixir of Happiness, an Elixir of Courage, an Elixir of Peace, an Elixir of Power, an Elixir of Insiration and the Cabinet (empty) here.

* * *

EntForest
An Interactive Fiction by Bruno
Release 1 / Serial number 210104 / Inform 7 build 6M62 (I6/v6.33 lib 6/12N) SD

GreenForest

Oh you mighty warrior, you are finding yourself in the Green Forest, the home of the cure, potions, and all the thing dear to a man to survive in this cruel and harsh world! 
Maybe you can find courage and power here to defeat the evil creatures that stand in your way to eternal life with the Ents!

You can see an Elixir of Courage, an Elixir of Peace, an Elixir of Inspiration, an ElvenKey and a Hole in the tree (closed) here.

>enter cabinet
That's not something you can enter.

>enter
You must supply a noun.

>open
What do you want to open?

>open cabinet
You open the Cabinet.

>enter cabinet
That's not something you can enter.

>close cabinet
You close the Cabinet.

>look cabinet
In the Cabinet is an Elixir of Happiness.

>take elixir of happiness
The Cabinet isn't open.

>open cabinet
You open the Cabinet.

>take elixir of happiness
Taken.

* * *

EntForest
An Interactive Fiction by Bruno
Release 1 / Serial number 210104 / Inform 7 build 6M62 (I6/v6.33 lib 6/12N) SD

GreenForest

Oh you mighty warrior, you are finding yourself in the Green Forest, the home of the cure, potions, and all the thing dear to a man to survive in this cruel and harsh world! 
Maybe you can find courage and power here to defeat the evil creatures that stand in your way to eternal life with the Ents!

You can see an Elixir of Courage, an Elixir of Peace, an Elixir of Inspiration, an ElvenKey and a Hole in the tree (closed) here.

>open hole
It seems to be locked.

>take elixir of power
Taken.

* * *

>open hole
It seems to be locked.

>unlock hole
What do you want to unlock the Hole in the wood with?

>unlock hole with key
You can't see any such thing.

* * *

>open hole
It seems to be locked.

>take key
Maybe some ancient people forgot about it. Must be to unlock something. It looks kinda elvish!

Taken.

>unlock hole
(with the Key)
You unlock the Hole in the wood.

>open hole
You open the Hole in the wood, revealing an Elixir of Happiness and an Elixir of Power.

* * *

EntForest
An Interactive Fiction by Bruno
Release 1 / Serial number 210104 / Inform 7 build 6M62 (I6/v6.33 lib 6/12N) SD

GreenForest

Oh you mighty warrior, you are finding yourself in the Green Forest, the home of the cure, potions, and all the thing dear to a man to survive in this cruel and harsh world! 
Maybe you can find courage and power here to defeat the evil creatures that stand in your way to eternal life with the Ents!

You can see an Elixir of Courage, an Elixir of Peace, an Elixir of Inspiration, an ElvenKey and a Hole in the tree (closed) here.

>take ElvvenKey
You can't see any such thing.

>take ElvenKey
Taken.

>unlock hole with elvenkey
You unlock the Hole in the wood.

>lock hole
(with the ElvenKey)
You lock the Hole in the wood.

>unlock hole
(with the ElvenKey)
You unlock the Hole in the wood.

>take elixir of powe
You can't see any such thing.

>take elixir of power
The Hole in the wood isn't open.

>open hole
You open the Hole in the wood.

>take elixir of power
Taken.

* * *

EntForest
An Interactive Fiction by Bruno
Release 1 / Serial number 210104 / Inform 7 build 6M62 (I6/v6.33 lib 6/12N) SD

GreenForest

Oh you mighty warrior, you are finding yourself in the Green Forest, the home of the cure, potions, and all the thing dear to a man to survive in this cruel and harsh world! 
Maybe you can find courage and power here to defeat the evil creatures that stand in your way to eternal life with the Ents!

You can see an Elixir of Courage, an Elixir of Peace, an Elixir of Inspiration, an ElvenKey and a Hole in the tree (closed) here.

>take key
Maybe some ancient people forgot about it. Must be to unlock something. It looks kinda elvish!

Taken.

* * *

>unlock hole
(with the Key)
You unlock the Hole in the wood.

>open
(the Key)
It isn't something you can open.

>open hole
You open the Hole in the wood.

* * *

>unlock hole
(with the Key)
You unlock the Hole in the wood.

>look hole
Strange hole in the ground. Who knows what opening up the hole in the wood can bring you or where it could take you. Maybe it contains happiness? Maybe power? Maybe just nothing? Oh well . . .

>see hole
That's not a verb I recognise.

>enter hole
That's not something you can enter.

>open hole
You open the Hole in the wood, revealing an Elixir of Happiness and an Elixir of Power.

* * *

>look hole
Strange hole in the ground. Who knows what opening up the hole in the wood can bring you or where it could take you. Maybe it contains happiness? Maybe power? Maybe just nothing? Oh well . . .

>take elixir of happiness
You can't see any such thing.

>open hole
You open the Hole in the wood, revealing an Elixir of Happiness and an Elixir of Power.

>take elixir of happiness
BlueForest
You can find yourself in the Blue Forest where you see things of great value that can help you on your journey across the Cursed Forest. You can see a desk with weapons that were forged in the eternal fires and cooled down in the freezing deeps of the northern sea!

Taken.

* * *

>open hole
You open the Hole in the wood, revealing an Elixir of Happiness and an Elixir of Power.

>take elixir of hapiness
You can't see any such thing.

>take Elixir of happiness
BlueForest
You can find yourself in the Blue Forest where you see things of great value that can help you on your journey across the Cursed Forest. You can see a desk with weapons that were forged in the eternal fires and cooled down in the freezing deeps of the northern sea!

Taken.

>look PlayerMove
You can't see any such thing.

>PlayerMove
That's not a verb I recognise.

* * *

>open hole
You open the Hole in the wood, revealing an Elixir of Happiness and an Elixir of Power.

>take elixir of happiness
HappyValley
Okay you are happy for now. But what about eternal happiness with the Ents? You must want that. Get back to the woods and find a away to defeat the evil creatures! You can go west to get back to the Green forest

Taken.

>w
GreenForest
Oh you mighty warior, you are finding yourself in the Green Forest, the home of the cure, potions, and all the thing dear to a man to survive in this cruel and harsh world! Maybe you can find courage and power here to defeat the evil creatures that stand in your way to the eternal life with the Ents!

You can see an Elixir of Courage, an Elixir of Peace and a Hole in the wood (in which is an Elixir of Power) here.

>e
HappyValley
Okay you are happy for now. But what about eternal happiness with the Ents? You must want that. Get back to the woods and find a away to defeat the evil creatures! You can go west to get back to the Green forest

>w
GreenForest
Oh you mighty warior, you are finding yourself in the Green Forest, the home of the cure, potions, and all the thing dear to a man to survive in this cruel and harsh world! Maybe you can find courage and power here to defeat the evil creatures that stand in your way to the eternal life with the Ents!

You can see an Elixir of Courage, an Elixir of Peace and a Hole in the wood (in which is an Elixir of Power) here.

>w
BlueForest
You can find yourself in the Blue Forest where you see things of great value that can help you on your journey across the Cursed Forest. You can see a desk with weapons that were forged in the eternal fires and cooled down in the freezing deeps of the northern sea!

>e
GreenForest
Oh you mighty warior, you are finding yourself in the Green Forest, the home of the cure, potions, and all the thing dear to a man to survive in this cruel and harsh world! Maybe you can find courage and power here to defeat the evil creatures that stand in your way to the eternal life with the Ents!

You can see an Elixir of Courage, an Elixir of Peace and a Hole in the wood (in which is an Elixir of Power) here.

>e
HappyValley
Okay you are happy for now. But what about eternal happiness with the Ents? You must want that. Get back to the woods and find a away to defeat the evil creatures! You can go west to get back to the Green forest

* * *

>open hole
You open the Hole in the wood, revealing an Elixir of Happiness and an Elixir of Power.

>close hole
You close the Hole in the wood.

>open hole in the wood
You open the Hole in the wood, revealing an Elixir of Happiness and an Elixir of Power.

>look hole
That looks like a strange hole . . .

In the Hole in the wood are an Elixir of Happiness and an Elixir of Power.

>open hole
That's already open.

>close hole
You close the Hole in the wood.

>open hole
You open the Hole in the wood, revealing an Elixir of Happiness and an Elixir of Power.

* * *

>take key
Maybe some ancient people forgot about it. Must be to unlock something. It looks kinda elvish!

Taken.

>drop key
Dropped.

>take key
Maybe some ancient people forgot about it. Must be to unlock something. It looks kinda elvish!

Taken.

* * *

EntForest
An Interactive Fiction by Bruno
Release 1 / Serial number 210104 / Inform 7 build 6M62 (I6/v6.33 lib 6/12N) SD

GreenForest

Oh you mighty warrior, you are finding yourself in the Green Forest, the home of the cure, potions, and all the thing dear to a man to survive in this cruel and harsh world! 
Maybe you can find courage and power here to defeat the evil creatures that stand in your way to eternal life with the Ents!

You can see an Elixir of Courage, an Elixir of Peace, an Elixir of Inspiration, an ElvenKey and a Hole in the tree (closed) here.

>look container
You can't see any such thing.

>look
GreenForest
Oh you mighty warior, you are finding yourself in the Green Forest, the home of the cure, potions, and all the thing dear to a man to survice in this cruel and harsh world!

Hmm . . . There is some key on the ground? Maybe some ancient people forgot about it. Must be to unlock something. It looks kinda elvish!

You can also see an Elixir of Courage and an Elixir of Peace here.

* * *

EntForest
An Interactive Fiction by Bruno
Release 1 / Serial number 210104 / Inform 7 build 6M62 (I6/v6.33 lib 6/12N) SD

GreenForest

Oh you mighty warrior, you are finding yourself in the Green Forest, the home of the cure, potions, and all the thing dear to a man to survive in this cruel and harsh world! 
Maybe you can find courage and power here to defeat the evil creatures that stand in your way to eternal life with the Ents!

You can see an Elixir of Courage, an Elixir of Peace, an Elixir of Inspiration, an ElvenKey and a Hole in the tree (closed) here.

>look hole
Strange hole in the ground. Who knows what opening up the hole in the wood can bring you. Maybe happiness? Maybe power? Maybe just nothing? Oh well . . .

>look hole in the ground
I only understood you as far as wanting to look the Hole in the wood.

>look hole in the wood
You see nothing special about the Hole in the wood.

>open hole
It seems to be locked.

* * *

>unlock hole
What do you want to unlock the Hole in the wood with?

>pick key
I didn't understand that sentence.

>tak key
That's not a verb I recognise.

>take key
Taken.

>inv
You are carrying:
  a Key

>unlock hole
(with the Key)
You unlock the Hole in the wood.

* * *

>open hole
You open the Hole in the wood, revealing an Elixir of Happiness and an Elixir of Power.

>take elixir
Which do you mean, the Elixir of Courage, the Elixir of Peace, the Elixir of Happiness or the Elixir of Power?

>elixir of power
Taken.

>close hole
You close the Hole in the wood.

>inv
You are carrying:
  an Elixir of Power
  a Key

>drop key
Dropped.

>inv
You are carrying:
  an Elixir of Power

* * *

>look hole
Strange hole in the ground. Who knows what opening up the hole in the wood can bring you. Maybe happiness? Maybe power? Maybe just nothing? Oh well . . .

>hole
That's not a verb I recognise.

>lookup hole
That's not a verb I recognise.

>look up hole
I only understood you as far as wanting to look up.

>desc hole
That's not a verb I recognise.

>description of hole
That's not a verb I recognise.

>what is hole
That's not a verb I recognise.

>what hole
That's not a verb I recognise.

>see hole
That's not a verb I recognise.

* * *

>enter hole
That's not something you can enter.

>open hole
It seems to be locked.

>take key
Taken.

>unlock hole
(with the Key)
You unlock the Hole in the wood.

>look hole
You see nothing special about the Hole in the wood.

* * *

EntForest
An Interactive Fiction by Bruno
Release 1 / Serial number 210104 / Inform 7 build 6M62 (I6/v6.33 lib 6/12N) SD

GreenForest

Oh you mighty warrior, you are finding yourself in the Green Forest, the home of the cure, potions, and all the thing dear to a man to survive in this cruel and harsh world! 
Maybe you can find courage and power here to defeat the evil creatures that stand in your way to eternal life with the Ents!

You can see an Elixir of Courage, an Elixir of Peace, an Elixir of Inspiration, an ElvenKey and a Hole in the tree (closed) here.

>e
CursedForest
Ground hasn't seen the ligh for ages, rivers stopped flowing and leaves mourn the life that was once here, but no more. Cursed is the place where you are. Be aware of going alone. Don't even try without right equipment. The Orcs on the branches fight until the end and guard the entrance of the forest. If you win the fight you will come across the Trolls that smash hard and fear no one! If you manage to get through all of that, only magic can save you becase Deamon from the deep, the almighty ghost that roams these forest is feared by all living things and no solid thing can hurt him!

Go east if you dare . . .

>e
You will lose your life, don't risk it. Find the right items my friend!

GreenForest
Oh you mighty warrior, you are finding yourself in the Green Forest, the home of the cure, potions, and all the thing dear to a man to survive in this cruel and harsh world! Maybe you can find courage and power here to defeat the evil creatures that stand in your way to the eternal life with the Ents!

You can see Blue forest rising in the west and in the east there is a Cursed forest and the road you must take!

You can see an Elixir of Courage, an Elixir of Peace, an Elixir of Inspiration, an ElvenKey and a Hole in the tree (closed) here.

>e
GreenForest
Oh you mighty warior, you are finding yourself in the Green Forest, the home of the cure, potions, and all the thing dear to a man to survive in this cruel and harsh world! Maybe you can find courage and power here to defeat the evil creatures that stand in your way to the eternal life with the Ents!

Hmm . . . There is some key on the ground? Maybe some ancient people forgot about it. Must be to unlock something. It looks kinda elvish!

You can also see an Elixir of Courage, an Elixir of Peace and a Hole in the wood (closed) here.

You're not happy

>take key
Taken.

* * *

>w
GreenForest
Oh you mighty warior, you are finding yourself in the Green Forest, the home of the cure, potions, and all the thing dear to a man to survive in this cruel and harsh world! Maybe you can find courage and power here to defeat the evil creatures that stand in your way to the eternal life with the Ents!

You can see an Elixir of Courage, an Elixir of Peace and a Hole in the wood (in which is an Elixir of Power) here.

>close hole
You close the Hole in the wood.

>look
GreenForest
Oh you mighty warior, you are finding yourself in the Green Forest, the home of the cure, potions, and all the thing dear to a man to survive in this cruel and harsh world! Maybe you can find courage and power here to defeat the evil creatures that stand in your way to the eternal life with the Ents!

You can see an Elixir of Courage, an Elixir of Peace and a Hole in the wood (closed) here.

>e
HappyValley
Okay you are happy for now. But what about eternal happiness with the Ents? You must want that. Get back to the woods and find a away to defeat the evil creatures! You can go west to get back to the Green forest

>e
You can't go that way.

* * *

>n
You can't go that way.

>w
GreenForest
Oh you mighty warior, you are finding yourself in the Green Forest, the home of the cure, potions, and all the thing dear to a man to survive in this cruel and harsh world! Maybe you can find courage and power here to defeat the evil creatures that stand in your way to the eternal life with the Ents!

You can see an Elixir of Courage, an Elixir of Peace and a Hole in the wood (closed) here.

* * *

>s
You can't go that way.

>n
GreenForest
Oh you mighty warior, you are finding yourself in the Green Forest, the home of the cure, potions, and all the thing dear to a man to survive in this cruel and harsh world! Maybe you can find courage and power here to defeat the evil creatures that stand in your way to the eternal life with the Ents!

You can see an Elixir of Courage, an Elixir of Peace, an Elixir of Inspiration, an ElvenKey and a Hole in the wood (closed) here.

You're not happy, you can't go north yet, or maybe you don't need to go at all?

>n
GreenForest
Oh you mighty warior, you are finding yourself in the Green Forest, the home of the cure, potions, and all the thing dear to a man to survive in this cruel and harsh world! Maybe you can find courage and power here to defeat the evil creatures that stand in your way to the eternal life with the Ents!

You can see an Elixir of Courage, an Elixir of Peace, an Elixir of Inspiration, an ElvenKey and a Hole in the wood (closed) here.

You're not happy, you can't go north yet, or maybe you don't need to go at all?

>w
BlueForest
You can find yourself in the Blue Forest where you see things of great value that can help you on your journey across the Cursed Forest. You can see a wooden desk with weapons that were forged in the eternal fires and cooled down in the freezing deeps of the northern sea! Maybe some friend can help you on your journey aswell?

You can see a Gates of fortress, Archer, Wizard, Swordsman, a Grass (closed) and a Wooden desk (closed) here.

>e
GreenForest
Oh you mighty warior, you are finding yourself in the Green Forest, the home of the cure, potions, and all the thing dear to a man to survive in this cruel and harsh world! Maybe you can find courage and power here to defeat the evil creatures that stand in your way to the eternal life with the Ents!

You can see an Elixir of Courage, an Elixir of Peace, an Elixir of Inspiration, an ElvenKey and a Hole in the wood (closed) here.

>take elixir of courage
Taken.

>take Elven
You can't see any such thing.

>take ElvenKey
Maybe some ancient people forgot about it. Must be to unlock something. It looks kinda elvish!

Taken.

>unlock Hole
What do you want to unlock the Hole in the wood with?

>unlock Hole with ElvenKey
You unlock the Hole in the wood.

>open hole
You open the Hole in the wood, revealing an Elixir of Happiness and an Elixir of Power.

>take power
Taken.

>n
GreenForest
Oh you mighty warior, you are finding yourself in the Green Forest, the home of the cure, potions, and all the thing dear to a man to survive in this cruel and harsh world! Maybe you can find courage and power here to defeat the evil creatures that stand in your way to the eternal life with the Ents!

You can see an Elixir of Peace, an Elixir of Inspiration and a Hole in the wood (in which is an Elixir of Happiness) here.

You're not happy, you can't go north yet, or maybe you don't need to go at all?

>w
BlueForest
You can find yourself in the Blue Forest where you see things of great value that can help you on your journey across the Cursed Forest. You can see a wooden desk with weapons that were forged in the eternal fires and cooled down in the freezing deeps of the northern sea! Maybe some friend can help you on your journey aswell?

You can see a Gates of fortress, Archer, Wizard, Swordsman, a Grass (closed) and a Wooden desk (closed) here.

>open grass
You open the Grass, revealing a GrassKey.

* * *

>take GrassKey
Taken.

>unlock Wooden deks
I didn't understand that sentence.

>unlock Wooden desk
What do you want to unlock the Wooden desk with?

>unlock Wooden desk with GrassKey
You unlock the Wooden desk.

>unlock Wooden desk
What do you want to unlock the Wooden desk with?

>open desk
You open the Wooden desk, revealing White staff, Green staff and Black staff.

>take White staff
Taken.

>open gates
You open the Gates of fortress.

>go gates
OldElvenFortress
Forgoten for ages, lost in the books, now only ruins remain of once great elven fortress. Mistery surrounds this place, ghost fly by you, but don't be scared, it's a peaceful place. Try to find something useful. It looks like there's still some weapons here that stood for ages and are stiill standing like the time stopped for them. Must be that Elves used some kind of magic on them. . . But be aware that while you look out for weapons you're enemies grow stronger!

You can see a Gates of fortress, White arrow, Green arrow, Black arrow and Stone grave (closed) here.

>take green arrow
Taken.

>open stone grave
You open Stone grave, revealing White sword, Green sword and Black sword.

>take black sword
Taken.

* * *

>n
BlueForest
You can find yourself in the Blue Forest where you see things of great value that can help you on your journey across the Cursed Forest. You can see a wooden desk with weapons that were forged in the eternal fires and cooled down in the freezing deeps of the northern sea! Maybe some friend can help you on your journey aswell?

You can see a Gates of fortress, Archer, Wizard, Swordsman, a Grass (empty) and a Wooden desk (in which are Green staff and Black staff) here.

>n
You can't go that way.

* * *

>w
You can't go that way.

>e
GreenForest
Oh you mighty warior, you are finding yourself in the Green Forest, the home of the cure, potions, and all the thing dear to a man to survive in this cruel and harsh world! Maybe you can find courage and power here to defeat the evil creatures that stand in your way to the eternal life with the Ents!

You can see an Elixir of Peace, an Elixir of Inspiration and a Hole in the wood (in which is an Elixir of Happiness) here.

>e
CursedForest
Ground hasn't seen the ligh for ages, rivers stopped flowing and leaves mourn the life that was once here, but no more. Cursed is the place where you are. Be aware of going alone. Don't even try without right equipment. The Orcs on the branches fight until the end and guard the entrance of the forest. If you win the fight you will come across the Trolls that smash hard and fear no one! If you manage to get through all of that, only magic can save you becase Deamon from the deep, the almighty ghost that roams these forest is feared by all living things and no solid thing can hurt him!

* * *

>take elixir of courage
Taken.

>e
CursedForest
Ground hasn't seen the ligh for ages, rivers stopped flowing and leaves mourn the life that was once here, but no more. Cursed is the place where you are. Be aware of going alone. Don't even try without right equipment. The Orcs on the branches fight until the end and guard the entrance of the forest. If you win the fight you will come across the Trolls that smash hard and fear no one! If you manage to get through all of that, only magic can save you becase Deamon from the deep, the almighty ghost that roams these forest is feared by all living things and no solid thing can hurt him!

Go east if you dare . . .

>e
You will lose your life, don't risk it. Find the right items my friend!

GreenForest
Oh you mighty warrior, you are finding yourself in the Green Forest, the home of the cure, potions, and all the thing dear to a man to survive in this cruel and harsh world! Maybe you can find courage and power here to defeat the evil creatures that stand in your way to the eternal life with the Ents!

You can see Blue forest rising in the west and in the east there is a Cursed forest and the road you must take!

You can see an Elixir of Peace, an Elixir of Inspiration, an ElvenKey and a Hole in the tree (closed) here.

>inv
You are carrying:
  an Elixir of Courage

>e
CursedForest
Ground hasn't seen the ligh for ages, rivers stopped flowing and leaves mourn the life that was once here, but no more. Cursed is the place where you are. Be aware of going alone. Don't even try without right equipment. The Orcs on the branches fight until the end and guard the entrance of the forest. If you win the fight you will come across the Trolls that smash hard and fear no one! If you manage to get through all of that, only magic can save you becase Deamon from the deep, the almighty ghost that roams these forest is feared by all living things and no solid thing can hurt him!

Go east if you dare . . .

* * *

>tak ElvenKey
That's not a verb I recognise.

>take ElvenKey
Maybe some ancient people forgot about it. Must be to unlock something. It looks kinda elvish!

Taken.

>unlock desk
You can't see any such thing.

>unlock hole
What do you want to unlock the Hole in the tree with?

>unlock hole with key
You can't see any such thing.

>unlock hole with elvenkey
You unlock the Hole in the tree.

>open hole
You open the Hole in the tree, revealing an Elixir of Happiness and an Elixir of Power.

>take elixir of power
Taken.

>e
CursedForest
Ground hasn't seen the ligh for ages, rivers stopped flowing and leaves mourn the life that was once here, but no more. Cursed is the place where you are. Be aware of going alone. Don't even try without right equipment. The Orcs on the branches fight until the end and guard the entrance of the forest. If you win the fight you will come across the Trolls that smash hard and fear no one! If you manage to get through all of that, only magic can save you becase Deamon from the deep, the almighty ghost that roams these forest is feared by all living things and no solid thing can hurt him!

Go east if you dare . . .

>e
You will lose your life, don't risk it. Find the right items my friend!

GreenForest
Oh you mighty warrior, you are finding yourself in the Green Forest, the home of the cure, potions, and all the thing dear to a man to survive in this cruel and harsh world! Maybe you can find courage and power here to defeat the evil creatures that stand in your way to the eternal life with the Ents!

You can see Blue forest rising in the west and in the east there is a Cursed forest and the road you must take!

You can see an Elixir of Peace, an Elixir of Inspiration and a Hole in the tree (in which is an Elixir of Happiness) here.

>w
BlueForest
You can find yourself in the Blue Forest where you see things of great value that can help you on your journey across the Cursed Forest. You can see a wooden desk with weapons that were forged in the eternal fires and cooled down in the freezing deeps of the northern sea! Maybe some friend can help you on your journey aswell?

You can see Green forest rising in the east and Old Elven fortress standing in the south!

You can see a Gates of fortress, Archer, Wizard, Swordsman, a Grass (closed) and a Wooden desk (closed) here.

>look wizard
He is useless without his staff. Find him his weapon and summon his to the Cursed forest to aid you, you need your friends!

>open grass
You open the Grass, revealing a GrassKey.

>take grasskey
Taken.

>unlock wooden desk
What do you want to unlock the Wooden desk with?

>unlock wooden desk with grass key
I only understood you as far as wanting to unlock the Wooden desk with the Grass.

>unlock wooden desk with grasskey
You unlock the Wooden desk.

>open desk
You open the Wooden desk, revealing White staff, Green staff and Black staff.

>take white staff
You have summoned the White Wizard to the Cursed forest!

Taken.

>open gates
You open the Gates of fortress.

>enter fortress
OldElvenFortress
Forgoten for ages, lost in the books, now only ruins remain of once great elven fortress. Mistery surrounds this place, ghost fly by you, but don't be scared, it's a peaceful place. Try to find something useful. It looks like there's still some weapons here that stood for ages and are stiill standing like the time stopped for them. Must be that Elves used some kind of magic on them. . . But be aware that while you look out for weapons your enemies grow stronger!

You can see a Gates of fortress, White arrow, Green arrow, Black arrow and Stone grave (closed) here.

>take green arrow
You have summoned the Green Archer to the Cursed forest!

Taken.

>open grave
You open Stone grave, revealing White sword, Green sword and Black sword.

>take black sword
You have summoned the Black Swordsman to the Cursed forest!

Taken.

>n
BlueForest
You can find yourself in the Blue Forest where you see things of great value that can help you on your journey across the Cursed Forest. You can see a wooden desk with weapons that were forged in the eternal fires and cooled down in the freezing deeps of the northern sea! Maybe some friend can help you on your journey aswell?

You can see Green forest rising in the east and Old Elven fortress standing in the south!

You can see a Gates of fortress, a Grass (empty) and a Wooden desk (in which are Green staff and Black staff) here.

>e
GreenForest
Oh you mighty warrior, you are finding yourself in the Green Forest, the home of the cure, potions, and all the thing dear to a man to survive in this cruel and harsh world! Maybe you can find courage and power here to defeat the evil creatures that stand in your way to the eternal life with the Ents!

You can see Blue forest rising in the west and in the east there is a Cursed forest and the road you must take!

You can see an Elixir of Peace, an Elixir of Inspiration and a Hole in the tree (in which is an Elixir of Happiness) here.

>e
CursedForest
Ground hasn't seen the ligh for ages, rivers stopped flowing and leaves mourn the life that was once here, but no more. Cursed is the place where you are. Be aware of going alone. Don't even try without right equipment. The Orcs on the branches fight until the end and guard the entrance of the forest. If you win the fight you will come across the Trolls that smash hard and fear no one! If you manage to get through all of that, only magic can save you becase Deamon from the deep, the almighty ghost that roams these forest is feared by all living things and no solid thing can hurt him!

Go east if you dare . . .

You can see Swordsman, Archer and Wizard here.

>e
EntForest
You are in peace my friend. Congratulations!

>w
CursedForest
Ground hasn't seen the ligh for ages, rivers stopped flowing and leaves mourn the life that was once here, but no more. Cursed is the place where you are. Be aware of going alone. Don't even try without right equipment. The Orcs on the branches fight until the end and guard the entrance of the forest. If you win the fight you will come across the Trolls that smash hard and fear no one! If you manage to get through all of that, only magic can save you becase Deamon from the deep, the almighty ghost that roams these forest is feared by all living things and no solid thing can hurt him!

Go east if you dare . . .

You can see Swordsman, Archer and Wizard here.

>look  sword
Black sword is the one that all Orcs fear and flee before it!

>look  swordsman
He is useless without his sword. Find him his weapon and summon his to the Cursed forest to aid you, you need your friends!

* * *

EntForest
An Interactive Fiction by Bruno
Release 1 / Serial number 210104 / Inform 7 build 6M62 (I6/v6.33 lib 6/12N) SD

GreenForest

Oh you mighty warrior, you are finding yourself in the Green Forest, the home of the cure, potions, and all the thing dear to a man to survive in this cruel and harsh world! 
Maybe you can find courage and power here to defeat the evil creatures that stand in your way to eternal life with the Ents!

You can see an Elixir of Courage, an Elixir of Peace, an Elixir of Inspiration, an ElvenKey and a Hole in the tree (closed) here.

>n
GreenForest
Oh you mighty warior, you are finding yourself in the Green Forest, the home of the cure, potions, and all the thing dear to a man to survive in this cruel and harsh world! Maybe you can find courage and power here to defeat the evil creatures that stand in your way to the eternal life with the Ents!

Hmm . . . There is some key on the ground? Maybe some ancient people forgot about it. Must be to unlock something. It looks kinda elvish!

You can also see an Elixir of Courage, an Elixir of Peace and a Hole in the wood (closed) here.

You're not happy, you can't go east yet

>w
BlueForest
You can find yourself in the Blue Forest where you see things of great value that can help you on your journey across the Cursed Forest. You can see a desk with weapons that were forged in the eternal fires and cooled down in the freezing deeps of the northern sea!

>n
GreenForest
Oh you mighty warior, you are finding yourself in the Green Forest, the home of the cure, potions, and all the thing dear to a man to survive in this cruel and harsh world! Maybe you can find courage and power here to defeat the evil creatures that stand in your way to the eternal life with the Ents!

Hmm . . . There is some key on the ground? Maybe some ancient people forgot about it. Must be to unlock something. It looks kinda elvish!

You can also see an Elixir of Courage, an Elixir of Peace and a Hole in the wood (closed) here.

You're not happy, you can't go east yet

* * *

>e
CursedForest
The ground hasn't seen the light for ages, rivers stopped flowing and leaves mourn the life that was once here, but no more. Cursed is the place where you are. Be aware of going alone. Don't even try without the right equipment. The Orcs on the branches fight until the end and guard the entrance of the forest. If you win the fight, you will come across the Trolls that smash hard and fear no one! If you manage to get through all of that, only magic can save you because Demon from the deep, the almighty ghost that roams this forest is feared by all living things and no solid thing can hurt him!

Go south if you dare . . .

>w
GreenForest
Oh you mighty warrior, you are finding yourself in the Green Forest, the home of the cure, potions, and all the thing dear to a man to survive in this cruel and harsh world! Maybe you can find courage and power here to defeat the evil creatures that stand in your way to the eternal life with the Ents!

You can see Blue forest rising in the west and in the east there is a Cursed forest and the road you must take!

You can see an Elixir of Courage, an Elixir of Peace, an Elixir of Inspiration, an ElvenKey and a Hole in the tree (closed) here.

>n
GreenForest
Oh you mighty warrior, you are finding yourself in the Green Forest, the home of the cure, potions, and all the thing dear to a man to survive in this cruel and harsh world! Maybe you can find courage and power here to defeat the evil creatures that stand in your way to the eternal life with the Ents!

You can see Blue forest rising in the west and in the east there is a Cursed forest and the road you must take!

You can see an Elixir of Courage, an Elixir of Peace, an Elixir of Inspiration, an ElvenKey and a Hole in the tree (closed) here.

You're not happy, you can't go north yet, or maybe you don't need to go at all?

>w
BlueForest
You can find yourself in the Blue Forest where you see things of great value that can help you on your journey across the Cursed Forest. You can see a wooden desk with weapons that were forged in the eternal fires and cooled down in the freezing deeps of the northern sea! Maybe some friend can help you on your journey aswell?

You can see Green forest rising in the east and Old Elven fortress standing in the south!

You can see a Gates of fortress, Archer, Wizard, Swordsman, a Grass (closed) and a Wooden desk (closed) here.

* * *

>e
You can't go that way.

>s
EntForest
You are in peace, my friend. Your journey is now over. But don't be sad, you've got an eternal life with the Ents, just like we promised! Hope you enjoyed this adventure and now go take a rest, you deserved it!

>inv
You are carrying nothing.

* * *

>s
You will lose your life, don't risk it. Find the right items, my friend!

GreenForest
Oh you mighty warrior, you are finding yourself in the Green Forest, the home of the cure, potions, and all the thing dear to a man to survive in this cruel and harsh world! Maybe you can find courage and power here to defeat the evil creatures that stand in your way to eternal life with the Ents!

You can see an Elixir of Courage, an Elixir of Peace, an Elixir of Inspiration, an ElvenKey and a Hole in the tree (closed) here.

>w
BlueForest
You can find yourself in the Blue Forest where you see things of great value that can help you on your journey across the Cursed Forest. You can see a wooden desk with weapons that were forged in the eternal fires and cooled down in the freezing deeps of the northern sea! Maybe some friend can help you with your journey as well?

You can see a Gates of fortress, Archer, Wizard, Swordsman, a Grass (closed) and a Wooden desk (closed) here.

* * *

EntForest
An Interactive Fiction by Bruno
Release 1 / Serial number 210104 / Inform 7 build 6M62 (I6/v6.33 lib 6/12N) SD

GreenForest

Oh you mighty warrior, you are finding yourself in the Green Forest, the home of the cure, potions, and all the thing dear to a man to survive in this cruel and harsh world! 
Maybe you can find courage and power here to defeat the evil creatures that stand in your way to eternal life with the Ents!

You can see an Elixir of Courage, an Elixir of Peace, an Elixir of Inspiration, an ElvenKey and a Hole in the tree (closed) here.

>who am I
That's not a verb I recognise.

>who am i
That's not a verb I recognise.

>ask who am i
You can't see any such thing.

>look who am i
You can't see any such thing.

>ask player about who am i
You can't see any such thing.

>ask about who am i
You can't see any such thing.

>ask swordsman who am i
You can't see any such thing.

>w
BlueForest

You can find yourself in the Blue Forest where you see things of great value that can help you on your journey across the Cursed Forest. You can see a wooden desk with weapons that were forged in the eternal fires and cooled down in the freezing deeps of the northern sea!
Maybe some friend can help you with your journey as well?

You can see a Gates of fortress, Archer, Wizard, Swordsman, a Grass (closed) and a Wooden desk (closed) here.

>ask swordsman who am i
I only understood you as far as wanting to ask Swordsman.

>ask swordsman Who am I
I only understood you as far as wanting to ask Swordsman.

>ask Swordsman Who am I
I only understood you as far as wanting to ask Swordsman.

>ask Swordsman What race am I
I only understood you as far as wanting to ask Swordsman.

* * *

>ask Swordsman about what is your name
My name is Astellan.

>ask Swordsman about what race are you
I am a human!

>ask Swordsman about who are you
An ancient warrior in need for a sword!

>ask Swordsman
You can ask about: Who are you, What is your name, or What race are you.

>ask Swordsman who are you
I only understood you as far as wanting to ask Swordsman.

>ask Swordsman about who are you
An ancient warrior in need for a sword!

>ask Swordsman about what is your name
My name is Astellan.

>ask Swordsman about
You can ask about: Who are you, What is your name, or What race are you.

>ask wizard
You can ask about: Who are you, What is your name, or What race are you.

>ask wizard about who are you
Long forgotten wizard!

* * *

>ask wizard about what is your name
My name is Oberost.

>ask wizard about what race are you
I am a wizard, of course!

>ask archer about
You can ask about: Who are you, What is your name, or What race are you.

>ask archer about who are you
Friend of the forest!

>ask archer about what is your name
My name is Eruviel.

>ask archer about what race are you
I am an Elf!

* * *

EntForest
An Interactive Fiction by Bruno
Release 1 / Serial number 210104 / Inform 7 build 6M62 (I6/v6.33 lib 6/12N) SD

GreenForest

Oh you mighty warrior, you are finding yourself in the Green Forest, the home of the cure, potions, and all the thing dear to a man to survive in this cruel and harsh world! 
Maybe you can find courage and power here to defeat the evil creatures that stand in your way to eternal life with the Ents!

You can see an Elixir of Courage, an Elixir of Peace, an Elixir of Inspiration, an ElvenKey and a Hole in the tree (closed) here.

>take hole
How do you think you will carry that hole? Please, no more crazy mushrooms!

>w
BlueForest

You can find yourself in the Blue Forest where you see things of great value that can help you on your journey across the Cursed Forest. You can see a wooden desk with weapons that were forged in the eternal fires and cooled down in the freezing deeps of the northern sea!
Maybe some friend can help you with your journey as well?

You can see a Gates of fortress, Archer, Wizard, Swordsman, a Grass (closed) and a Wooden desk (closed) here.

>take gates
That's fixed in place.

>take grass
Really? You're a human man, not an cow!

>take desk
Where you are going they don't need wooden desks. Actually, I think they don't like things made of wood . . .

* * *

>s
(first opening the Gates of fortress)

OldElvenFortress

Forgotten for ages, lost in the books, now only ruins remain of once a great elven fortress. Mystery surrounds this place, ghost fly by you, but don't be scared, it's a peaceful place. Try to find something useful. It looks like there are still some weapons here that stood for ages and are still standing like the time stopped for them. It must be that Elves used some kind of magic on them. . . But be aware that while you look out for weapons your enemies grow stronger!

You can see a Gates of fortress, White arrow, Green arrow, Black arrow and Stone grave (closed) here.

>take grave
It's not polite to take someone's grave with you . . .

>commands
That's not a verb I recognise.

>command
That's not a verb I recognise.

>see commands
That's not a verb I recognise.